111111111111111111111111111111
10P000000000000000000000000001
1000C00000000000000000C0000001
1000000001000000001000000E0C01
100000000000000000000000000001
111111111111111111111111111111