111111111111111111111111111111
1P0000000000000000X00000000001
1000C0000000000X000000C0000001
1000000001000000001000000E0C01
100X0000000000X0000000X0000001
111111111111111111111111111111