111111111111111111111111111111
10P000000000000000000000000001
100000000000000000000000000001
100000000100000000100000000001
100000000000000000000000000001
111111111111111111111111111111