1111111111111111111111111111111111111111111111111111111
1111111111111111111111111111111111111111111111111111111
11P10C00000000010000000001X0000000000C0000000000C100X11
1101011111111101X11111010111110111111111111111110101C11
11010001X100000101C00001000000010C010000000001010101011
1101110101011111110111111111111101110111110101010101011
110000010100000001010000010001X000000100000100010101011
1111111101111111010101110101011101111101111111010111011
1100000001000C000100000100010001X0010001C0X100C10001011
1101111111011111111111111111110111110111011101111101011
1100000000010001X00000010000C00100000100010001000001011
11011111111101010101110101111111011111C1110111011111011
1100000001X00101010100C10100010001X000010000X10100C1011
1111111101110101010101110101110101111101011111010101011
11X1000100000101010100000101000101000100010100010100011
1101010111111101110111111101011101C10101110101110111011
11000100000001000101000000C001X100010100000101C00101011
11011111110111110101011111111101111101111101010111C1C11
1101000001010001010100000000010001000100010101000101011
1101X11101010101010111111111011101011101011101110100011
110001X001000100C001X0C0000000000100C001000C00000100E11
1111111111111111111111111111111111111111111111111111111
1111111111111111111111111111111111111111111111111111111