1111111111111
1P00001000C01
10000000C0101
1C0100E0X0001
1001C0X001001
1111111111111
